16 16
################
#D...#...#.....#
##.....#.#.....#
#....#......#.##
#........#.....#
##.#.#...##...##
#.........######
#.#....#.......#
#..............#
###.##....##.###
#....##..##...##
#.##..#..#.....#
#..#.....#..#.##
#..##.#..#.....#
#.....#..#.....#
################
3 3
17
2 5 255 0 0 1
4 5 0 255 0 1
5 4 0 255 255 1
5 2 255 0 255 1
2 1 0 255 255 3
6 4 0 255 255 -1
6 2 255 0 255 -1
4 6 0 255 0 -1
2 6 255 0 0 -1
3 9 255 0 0 -1
6 12 255 0 0 1
5 12 0 255 255 -1
2 13 0 255 255 -1
12 9 0 255 0 1
9 3 255 0 255 -1
10 3 0 255 255 -1
12 10 0 255 255 -1
