16 16
################
#......#.......#
#....#....#..#.#
#....#....#....#
#....#....####.#
#....#####.....#
#####....#..####
#........#....##
#.....#..#..#..#
#...#..#.#..#..#
#..#..#..#..#..#
#...#..#.#..#..#
#..#..#.##..#..#
#......#.#..#..#
#D.............#
################
1 1
35
2 2 255 95 75 -1
2 3 30 142 184 -1
2 4 255 95 75 1
3 3 255 95 75 1
3 2 30 142 184 -1
3 4 30 142 184 1
5 1 255 95 75 -2
4 1 30 142 184 2
9 1 255 219 102 2
7 3 255 219 102 -2
8 2 138 189 255 1
7 2 255 95 75 1
7 4 143 43 98 1
8 3 30 142 184 1
14 4 255 95 75 -1
12 2 255 95 75 1
12 1 30 142 184 -1
11 1 138 189 255 -1
11 10 143 43 98 1
11 9 255 95 75 1
11 8 143 43 98 1
11 7 255 95 75 1
11 6 255 219 102 1
11 11 255 95 75 1
11 12 255 219 102 1
10 14 255 95 75 1
11 14 255 95 75 -1
8 14 255 219 102 -1
7 14 255 219 102 1
2 14 255 219 102 -2
1 13 255 219 102 -2
7 7 255 219 102 1
5 7 255 95 75 1
5 8 207 122 219 1
5 9 30 142 184 1
