16 16
################
###...#..#.....#
##....#..#.....#
#.....#..#.....#
#.....#.#.#.#.##
#.........#....#
#####.....#....#
#.........#.#..#
#...#.......#..#
####......#.####
#...####.#.....#
#..............#
#...#........#.#
#...#.#####..#.#
#...#........#D#
################
2 2
24
2 3 255 219 102 1
2 4 255 219 102 -1
3 2 255 95 75 -1
4 2 255 95 75 1
14 13 255 95 75 5
14 12 255 219 102 5
5 5 255 219 102 -2
7 4 255 219 102 1
4 7 255 95 75 1
2 7 255 219 102 -3
7 2 255 95 75 -3
7 7 143 43 98 3
8 1207 122 219 255 -1
10 8 143 43 98 -1
12 13 255 219 102 -5
12 14 255 95 75 -5
11 7 143 43 98 -1
11 2 255 219 102 -2
4 11 143 43 98 1
2 12 255 95 75 -2
13 7 255 219 102 -2
12 6 138 189 255 -1
12 5 138 189 255 1
13 4 138 189 255 1
