16 16
################
#.#............#
#.##.####.###..#
#..............#
#.#.#.#.#.#.##.#
#.#.#...#.#.#..#
#.#.#.#.#.#.#..#
#.#.......#.#..#
#...#.#####....#
#.###........#.#
#.....#.###.##.#
#.###..........#
#...##.###.###.#
#.#............#
#.............D#
################
1 1
18
13 8 255 0 0 -1
14 8 255 255 0 -1
13 11 255 255 0 1
14 11 255 0 0 -1
13 3 255 255 0 1
14 3 255 0 0 -1
12 1 0 255 255 -1
9 1 255 0 0 -1
6 13 255 255 0 1
6 14 255 0 0 -1
10 13 255 0 0 -1
10 14 255 255 0 -1
1 13 255 0 0 -1
1 14 255 255 0 -1
2 12 0 255 255 -1
10 9 255 0 0 1
5 9 0 255 255 1
11 8 255 0 0 1
