16 16
################
#......#.......#
#....#....#..#.#
#....#....#....#
#....#....####.#
#....#####.....#
#####....#..####
#........#....##
#.....#..#..#..#
#...#..#.#..#..#
#..#..#..#..#..#
#...#..#.#..#..#
#..#..#.##..#..#
#......#.#..#..#
#D.............#
################
1 1
35
2 2 255 0 0 -1
2 3 0 0 255 -1
2 4 255 0 0 1
3 3 255 0 0 1
3 2 0 0 255 -1
3 4 0 0 255 1
5 1 255 0 0 -2
4 1 0 0 255 2
9 1 255 255 0 2
7 3 255 255 0 -2
8 2 0 255 255 1
7 2 255 0 0 1
7 4 255 0 255 1
8 3 0 0 255 1
14 4 255 0 0 -1
12 2 255 0 0 1
12 1 0 0 255 -1
11 1 0 255 255 -1
11 10 255 0 255 1
11 9 255 0 0 1
11 8 255 0 255 1
11 7 255 0 0 1
11 6 255 255 0 1
11 11 255 0 0 1
11 12 255 255 0 1
10 14 255 0 0 1
11 14 255 0 0 -1
8 14 255 255 0 -1
7 14 255 255 0 1
2 14 255 255 0 -2
1 13 255 255 0 -2
7 7 255 255 0 1
5 7 255 0 0 1
5 8 0 255 0 1
5 9 0 0 255 1
