16 16
################
#...#..........#
#.....#####....#
#........#..##.#
####.....##....#
#...####.#..#..#
#...#.##.......#
#......#######.#
#.#..........#.#
######.........#
##.............#
#..#.#########.#
#..#.......###.#
#..#.......###D#
##......#..#####
################
2 2
21
7 3 255 0 0 1
6 3 0 0 255 1
8 5 255 0 0 -1
11 6 0 0 255 -1
14 7 255 0 0 -1
11 3 255 0 0 1
12 6 255 255 0 1
13 6 0 0 255 -1
12 2 255 255 0 -1
14 8 255 0 255 1
14 9 0 255 255 1
14 10 255 255 0 1
6 8 255 0 255 -1
6 7 0 0 255 1
5 7 0 0 255 -1
2 6 0 0 255 1
3 6 0 0 255 -1
2 7 0 0 255 -1
8 12 0 255 255 -1
8 13 255 255 0 -1
6 12 0 255 255 1
