16 16
################
#..........#...#
####.......#...#
##.........#...#
##.##......#.###
#...#.#........#
#.......#.....##
#...#.#..#.##.##
#####..#.#.#...#
##.....#.......#
#........#.#...#
###.#......#.###
#...#.........##
#...#.......####
#...#.........D#
################
1 1
17
12 14 255 219 102 -8
13 2 255 219 102 2
2 13 255 219 102 2
3 11 207 122 219 1
3 12 255 95 75 1
12 4 255 95 75 -1
12 3 30 142 184 -1
2 1138 189 255 0 -1
13 10 30 142 184 1
11 9 30 142 184 -1
13 9 255 219 102 2
2 6 255 219 102 2
13 5 255 219 102 -1
4 6 30 142 184 1
13 8 30 142 184 1
2 4 207 122 219 -1
3 1 255 219 102 8
