16 16
################
#.#............#
#.##.####.###..#
#..............#
#.#.#.#.#.#.##.#
#.#.#...#.#.#..#
#.#.#.#.#.#.#..#
#.#.......#.#..#
#...#.#####....#
#.###........#.#
#.....#.###.##.#
#.###..........#
#...##.###.###.#
#.#............#
#.............D#
################
1 1
18
13 8 255 95 75 -1
14 8 255 219 102 -1
13 11 255 219 102 1
14 11 255 95 75 -1
13 3 255 219 102 1
14 3 255 95 75 -1
12 1 138 189 255 -1
9 1 255 95 75 -1
6 13 255 219 102 1
6 14 255 95 75 -1
10 13 255 95 75 -1
10 14 255 219 102 -1
1 13 255 95 75 -1
1 14 255 219 102 -1
2 12 138 189 255 -1
10 9 255 95 75 1
5 9 138 189 255 1
11 8 255 95 75 1
