29 28
############################
#D.#.#......#....##...#..###
#................#..#....###
##.#.#.#....#......#...#...#
#.......#...###.##...##..#.#
##.#.#......###........#...#
#...........##....#........#
#....#......####..#......#.#
#...##.#####################
#...#..#..#....#...#.......#
#...#..#....##.#...#.###.#.#
#...#.....##....#..#...#...#
#...#...#..#.#.....#.#.#.#.#
#...#####.#.....#..#.......#
#...#........#.#...#.#.#.#.#
#...#...#..........#...#...#
#...################.#...#.#
#...#........#.....#.......#
#...#..#..#....#.#.#.#.#.#.#
#...#...#.........##...#.#.#
#...#....#.#.#..#..#...#...#
#...#.........#...##.......#
#...#.......#...#..#..#.#..#
#...#.....#........#.......#
#...##.##################.##
#..........................#
#..........................#
#..........................#
############################
4 4
62
4 3 255 95 75 8
4 5 207 122 219 8
3 4 143 43 98 8
5 4 138 189 255 8
12 2 255 95 75 -8
6 8 138 189 255 -8
6 24 207 122 219 -8
25 24 143 43 98 -8
10 230 142 184 0 -4
1 2 255 219 102 -3
15 19 207 122 219 8
8 17 207 122 219 -8
23 13 255 219 102 1
22 13 255 95 75 1
24 13 255 95 75 1
20 13 143 43 98 1
26 13 138 189 255 1
20 12 255 95 75 -1
20 11 143 43 98 1
20 10 255 95 75 -1
20 9 143 43 98 1
26 12 255 95 75 -1
26 11 143 43 98 1
26 10 255 95 75 -1
26 9 143 43 98 1
25 20 143 43 98 -1
25 22 255 95 75 1
25 21 143 43 98 -1
21 22 143 43 98 -1
14 2 207 122 219 1
15 2 207 122 219 -1
15 4 207 122 219 -1
15 5 30 142 184 1
16 6 143 43 98 1
22 2 255 219 102 1
23 2 255 95 75 -4
18 3 255 95 75 1
20 6 255 95 75 1
21 5 255 95 75 1
26 4 255 95 75 1
6 10 30 142 184 1
6 11 30 142 184 -1
7 11 30 142 184 1
17 22 207 122 219 -4
6 14 255 219 102 1
8 14 143 43 98 -1
9 11 138 189 255 1
17 13 138 189 255 -1
17 12 138 189 255 1
17 11 138 189 255 -1
17 130 142 184 255 3
17 14 138 189 255 3
13 13 255 95 75 -5
13 11 255 95 75 -5
14 12 255 95 75 16
12 9 255 95 75 5
6 22 138 189 255 -1
6 21 138 189 255 1
16 18 255 219 102 1
13 21 138 189 255 -1
12 21 30 142 184 -1
2 1 255 219 102 -3
