16 16
################
#...#..........#
#...#.......#..#
#............#.#
#...#..##..#...#
####..........##
#...#..##..#####
#...#.......#..#
#...#..##...#..#
#..#..#.....#..#
#..............#
###....###...###
#.....#...#....#
#...#.....#..###
#...#.....#...D#
################
1 14
24
2 12 255 95 75 1
3 13 255 95 75 1
3 10 255 95 75 -2
5 12 255 95 75 -2
6 13 255 219 102 1
8 13 255 95 75 1
7 13 138 189 255 1
6 14 138 189 255 1
2 9 255 219 102 1
1 9 138 189 255 1
2 8 255 95 75 1
2 7 138 189 255 1
13 4 255 95 75 1
12 3 207 122 219 1
11 2 255 219 102 1
13 14 255 219 102 -5
2 3 255 219 102 1
2 2 207 122 219 1
8 5 255 219 102 -1
7 5 255 219 102 1
7 7 207 122 219 -3
8 7 207 122 219 1
12 130 142 184 255 -1
13 9 255 219 102 1
