16 16
################
#..####........#
#...##.....#...#
#......##.#....#
#..###.##..#...#
#.#....###..#..#
#.#.##.##..##..#
#.#.....#......#
#.##....#..###.#
#....##.#..#...#
#....#.###.....#
#.##...##...##.#
#....#.##......#
#....#..######.#
#.......#D.....#
################
1 1
16
3 3 0 255 255 1
3 2 0 255 0 1
2 2 0 0 255 1
2 3 255 0 0 1
6 2 0 0 255 -1
2 13 0 255 255 -1
6 8 0 255 0 1
5 8 0 255 255 1
7 8 0 255 255 1
11 7 255 0 0 1
12 7 255 255 0 1
13 7 255 0 0 -1
10 7 255 255 0 -1
9 12 255 0 0 1
14 13 255 255 0 1
13 3 255 0 0 -2
