29 28
############################
#D.#.#......#....##...#..###
#................#..#....###
##.#.#.#....#......#...#...#
#.......#...###.##...##..#.#
##.#.#......###........#...#
#...........##....#........#
#....#......####..#......#.#
#...##.#####################
#...#..#..#....#...#.......#
#...#..#....##.#...#.###.#.#
#...#.....##....#..#...#...#
#...#...#..#.#.....#.#.#.#.#
#...#####.#.....#..#.......#
#...#........#.#...#.#.#.#.#
#...#...#..........#...#...#
#...################.#...#.#
#...#........#.....#.......#
#...#..#..#....#.#.#.#.#.#.#
#...#...#.........##...#.#.#
#...#....#.#.#..#..#...#...#
#...#.........#...##.......#
#...#.......#...#..#..#.#..#
#...#.....#........#.......#
#...##.##################.##
#..........................#
#..........................#
#..........................#
############################
4 4
62
4 3 255 0 0 8
4 5 0 255 0 8
3 4 255 0 255 8
5 4 0 255 255 8
12 2 255 0 0 -8
6 8 0 255 255 -8
6 24 0 255 0 -8
25 24 255 0 255 -8
10 20 0 255 0 -4
1 2 255 255 0 -3
15 19 0 255 0 8
8 17 0 255 0 -8
23 13 255 255 0 1
22 13 255 0 0 1
24 13 255 0 0 1
20 13 255 0 255 1
26 13 0 255 255 1
20 12 255 0 0 -1
20 11 255 0 255 1
20 10 255 0 0 -1
20 9 255 0 255 1
26 12 255 0 0 -1
26 11 255 0 255 1
26 10 255 0 0 -1
26 9 255 0 255 1
25 20 255 0 255 -1
25 22 255 0 0 1
25 21 255 0 255 -1
21 22 255 0 255 -1
14 2 0 255 0 1
15 2 0 255 0 -1
15 4 0 255 0 -1
15 5 0 0 255 1
16 6 255 0 255 1
22 2 255 255 0 1
23 2 255 0 0 -4
18 3 255 0 0 1
20 6 255 0 0 1
21 5 255 0 0 1
26 4 255 0 0 1
6 10 0 0 255 1
6 11 0 0 255 -1
7 11 0 0 255 1
17 22 0 255 0 -4
6 14 255 255 0 1
8 14 255 0 255 -1
9 11 0 255 255 1
17 13 0 255 255 -1
17 12 0 255 255 1
17 11 0 255 255 -1
17 10 0 255 255 3
17 14 0 255 255 3
13 13 255 0 0 -5
13 11 255 0 0 -5
14 12 255 0 0 16
12 9 255 0 0 5
6 22 0 255 255 -1
6 21 0 255 255 1
16 18 255 255 0 1
13 21 0 255 255 -1
12 21 0 0 255 -1
2 1 255 255 0 -3
