16 16
################
#...#..........#
#...#.......#..#
#............#.#
#...#..##..#...#
####..........##
#...#..##..#####
#...#.......#..#
#...#..##...#..#
#..#..#.....#..#
#..............#
###....###...###
#.....#...#....#
#...#.....#..###
#...#.....#...D#
################
1 14
24
2 12 255 0 0 1
3 13 255 0 0 1
3 10 255 0 0 -2
5 12 255 0 0 -2
6 13 255 255 0 1
8 13 255 0 0 1
7 13 0 255 255 1
6 14 0 255 255 1
2 9 255 255 0 1
1 9 0 255 255 1
2 8 255 0 0 1
2 7 0 255 255 1
13 4 255 0 0 1
12 3 0 255 0 1
11 2 255 255 0 1
13 14 255 255 0 -5
2 3 255 255 0 1
2 2 0 255 0 1
8 5 255 255 0 -1
7 5 255 255 0 1
7 7 0 255 0 -3
8 7 0 255 0 1
12 10 0 255 255 -1
13 9 255 255 0 1
