16 16
################
#...#..........#
#.....#####....#
#........#..##.#
####.....##....#
#...####.#..#..#
#...#.##.......#
#......#######.#
#.#..........#.#
######.........#
##.............#
#..#.#########.#
#..#.......###.#
#..#.......###D#
##......#..#####
################
2 2
21
7 3 255 95 75 1
6 3 30 142 184 1
8 5 255 95 75 -1
11 6 30 142 184 -1
14 7 255 95 75 -1
11 3 255 95 75 1
12 6 255 219 102 1
13 6 30 142 184 -1
12 2 255 219 102 -1
14 8 143 43 98 1
14 9 138 189 255 1
14 1138 189 255 0 1
6 8 143 43 98 -1
6 7 30 142 184 1
5 7 30 142 184 -1
2 6 30 142 184 1
3 6 30 142 184 -1
2 7 30 142 184 -1
8 12 138 189 255 -1
8 13 255 219 102 -1
6 12 138 189 255 1
