16 16
################
###...#..#.....#
##....#..#.....#
#.....#..#.....#
#.....#.#.#.#.##
#.........#....#
#####.....#....#
#.........#.#..#
#...#.......#..#
####......#.####
#...####.#.....#
#..............#
#...#........#.#
#...#.#####..#.#
#...#........#D#
################
2 2
24
2 3 255 255 0 1
2 4 255 255 0 -1
3 2 255 0 0 -1
4 2 255 0 0 1
14 13 255 0 0 5
14 12 255 255 0 5
5 5 255 255 0 -2
7 4 255 255 0 1
4 7 255 0 0 1
2 7 255 255 0 -3
7 2 255 0 0 -3
7 7 255 0 255 3
8 10 255 0 255 -1
10 8 255 0 255 -1
12 13 255 255 0 -5
12 14 255 0 0 -5
11 7 255 0 255 -1
11 2 255 255 0 -2
4 11 255 0 255 1
2 12 255 0 0 -2
13 7 255 255 0 -2
12 6 0 255 255 -1
12 5 0 255 255 1
13 4 0 255 255 1
