16 16
################
#..####........#
#...##.....#...#
#......##.#....#
#..###.##..#...#
#.#....###..#..#
#.#.##.##..##..#
#.#.....#......#
#.##....#..###.#
#....##.#..#...#
#....#.###.....#
#.##...##...##.#
#....#.##......#
#....#..######.#
#.......#D.....#
################
1 1
16
3 3 138 189 255 1
3 2 207 122 219 1
2 2 30 142 184 1
2 3 255 95 75 1
6 2 30 142 184 -1
2 13 138 189 255 -1
6 8 207 122 219 1
5 8 138 189 255 1
7 8 138 189 255 1
11 7 255 95 75 1
12 7 255 219 102 1
13 7 255 95 75 -1
10 7 255 219 102 -1
9 12 255 95 75 1
14 13 255 219 102 1
13 3 255 95 75 -2
