16 16
################
#D...#...#.....#
##.....#.#.....#
#....#......#.##
#........#.....#
##.#.#...##...##
#.........######
#.#....#.......#
#..............#
###.##....##.###
#....##..##...##
#.##..#..#.....#
#..#.....#..#.##
#..##.#..#.....#
#.....#..#.....#
################
3 3
17
2 5 255 95 75 1
4 5 207 122 219 1
5 4 138 189 255 1
5 2 143 43 98 1
2 1 138 189 255 3
6 4 138 189 255 -1
6 2 143 43 98 -1
4 6 207 122 219 -1
2 6 255 95 75 -1
3 9 255 95 75 -1
6 12 255 95 75 1
5 12 138 189 255 -1
2 13 138 189 255 -1
12 9 207 122 219 1
9 3 143 43 98 -1
10 3 138 189 255 -1
12 130 142 184 255 -1
