16 16
################
#..........#...#
####.......#...#
##.........#...#
##.##......#.###
#...#.#........#
#.......#.....##
#...#.#..#.##.##
#####..#.#.#...#
##.....#.......#
#........#.#...#
###.#......#.###
#...#.........##
#...#.......####
#...#.........D#
################
1 1
17
12 14 255 255 0 -8
13 2 255 255 0 2
2 13 255 255 0 2
3 11 0 255 0 1
3 12 255 0 0 1
12 4 255 0 0 -1
12 3 0 0 255 -1
2 10 255 255 0 -1
13 10 0 0 255 1
11 9 0 0 255 -1
13 9 255 255 0 2
2 6 255 255 0 2
13 5 255 255 0 -1
4 6 0 0 255 1
13 8 0 0 255 1
2 4 0 255 0 -1
3 1 255 255 0 8
